24,0,-0.5,Modeus,,,,,
#,#,#,#,#,#,#,#,#
#,#,.,.,.,.,#,#,#
#,#,M,#,T,T,.,.,#
#,.,T,#,#,B/T,B/T,B,#
#,.,.,#,#,.,T,.,#
#,P,.,#,#,.,M,,#
#,#,#,#,#,G,.,M,#
#,#,#,#,#,#,#,#,#
