32,0.5,0,,,,,
#,#,#,#,#,#,#,#
#,#,#,#,G,.,#,#
#,#,#,#,.,L,.,#
#,.,K,#,B,B,B,#
#,M,B,.,M,B,.,#
#,.,#,M,.,.,P,#
#,S,#,#,H,#,#,#
#,H,S,H,S,#,#,#
#,#,#,#,#,#,#,#
