23,0.5,0,Malina,,,,,,
#,#,#,#,#,#,#,#,#,#
#,P,#,K,.,B,#,#,#,#
#,.,B,T,B/T,.,L,.,#,#
#,B,.,B,.,B,B,.,G,#
#,.,B,.,B,.,B,B,.,#
#,#,.,B,.,B,.,#,#,#
#,#,#,#,#,#,#,#,#,#
