23,0.5,0,Zdrada,,,,
#,#,#,#,#,#,#,#
#,#,#,#,.,G,#,#
#,#,#,.,L,B,.,#
#,P,#,D,.,B,.,#
#,.,#,.,D,.,D,#
#,M,#,B,B,B,B,#
#,D,.,D,.,.,D,#
#,#,#,#,#,#,K,#
#,#,#,#,#,#,#,#
