23,0.5,0,,,,,
#,#,#,#,#,#,#,#
#,#,#,#,.,G,#,#
#,#,#,.,L,B,.,#
#,P,#,H,.,B,.,#
#,.,#,.,H,.,H,#
#,M,#,B,B,B,B,#
#,H,.,H,.,.,H,#
#,#,#,#,#,#,K,#
#,#,#,#,#,#,#,#
