12,0,0,,,,,,,,
#,#,#,#,#,#,#,#,#,#,#
#,#,#,#,#,G,#,#,#,#,#
#,.,.,#,#,#,#,#,.,.,#
#,.,.,.,.,M,.,.,.,.,#
#,.,.,.,.,M,.,.,.,.,#
#,.,.,#,.,M,.,#,.,.,#
#,.,.,.,.,M,.,.,.,.,#
#,.,.,#,.,M,.,#,.,.,#
#,.,.,.,.,M,.,.,.,.,#
#,#,.,#,.,M,.,#,.,#,#
#,#,.,.,.,M,.,.,.,#,#
#,#,.,#,.,.,.,#,.,#,#
#,#,.,.,.,P,.,.,.,#,#
#,#,#,#,.,.,.,#,#,#,#
#,#,#,#,#,#,#,#,#,#,#
