43,0,-0.5,,,,,,
#,#,#,#,#,#,#,#,#
#,#,.,P,.,#,#,#,#
#,#,B,B,B,#,#,#,#
#,.,.,.,K,#,#,#,#
#,#,H,B/H,.,.,#,#,#
#,#,M,#,B,B,.,.,#
#,#,.,.,B,.,M,#,#
#,#,#,#,#,L,B,.,#
#,#,#,#,#,.,G,#,#
#,#,#,#,#,#,#,#,#
