32,0.5,0,Justice,,,,
#,#,#,#,#,#,#,#
#,#,#,#,G,.,#,#
#,#,#,#,.,L,.,#
#,.,K,#,B,B,B,#
#,M,B,.,M,B,.,#
#,.,#,M,.,.,P,#
#,U,#,#,D,#,#,#
#,D,U,D,U,#,#,#
#,#,#,#,#,#,#,#
