23,0,-0.5,PandeMonica,,,,,
#,#,#,#,#,#,#,#,#
#,#,#,#,#,.,P,#,#
#,#,.,.,M,.,.,#,#
#,#,.,M,.,M,#,#,#
#,.,.,#,#,#,#,#,#
#,.,B,.,.,B,.,#,#
#,.,B,.,B,.,.,G,#
#,#,#,#,#,#,#,#,#
