32,0.5,0,Cerberus,,,,,,
#,#,#,#,#,#,#,#,#,#
#,#,#,#,G,G,G,.,#,#
#,#,#,#,#,#,#,L,#,#
#,#,#,.,T,T,.,.,P,#
#,#,#,T,#,T,#,.,.,#
#,#,#,.,.,M,T,T,#,#
#,K,#,T,#,T,#,.,#,#
#,.,.,.,.,.,M,.,#,#
#,#,#,#,#,#,#,#,#,#
